6 13 31
###############################
#     p   4                   #
# # # # # # # # # # # # # # # #
##########                    #
# # # # # # # # # # # # # # # #
#                             #
# # # # # # # # # # # # # # # #
#                             #
# # # # # # # # # # # # # # # #
#                             #
# # # # # # # # # # # # # # # #
#                             #
###############################