6 13 31
###############################
#                             #
# # # # # # # # # # # # # # # #
######                        #
# # # # # # # # # # # # # # # #
#                             #
# # # # # # # # # # # # # # # #
#                             #
# # # # # # # # # # # # # # # #
#                    4        #
# # # # # # # # # # # # # # # #
#      p                      #
###############################